XXXXXXXXXXX
X  S     DX
X     C   X
X  W      X
X     K   X
X  M      X
XB        X
XXXXXXXXXXX