XXXXXXXXXXXXXXXXXXXXX
XBX     X X   X     X
X X XXX X X X X XXX X
X X X   X   X   X   X
X X X XXX X XXXXX XXX
X   X X   X X   X   X
XXXXX X XXX X XXX X X
X   X X X X X     X X
X XXX X X X XXXXXXX X
X X   X X X XK  X   X
X X X X X X XXX X XXX
X   X   X       X   X
XXXXXXXXXXXXXXXXXXX X
X   X       X       X
XXX X XXXXX X XXX XXX
X   X   X X   X X   X
X XXXXX X XXXXX XXX X
X         X     XDX X
XXXXXXX XXXXXXX X X X
X               X   X
XXXXXXXXXXXXXXXXXXXXX
